##########
#A..*....#
#..##..G.#
#....*...#
##########
