#########################
# *   *         *      *#
#  #### * #####   ####  #
#  #  #   #   # *  #  # #
#  #  # * #   #   *#  # #
#  ####   ##### * ####  #
#*      *        *      #
#  #### * ##### * ####  #
#  # #*#   # * #   #  # #
#  #  #   *#   #   #  # #
#  ####   #####   ####* #
# *      *        *     #
#########################