#############################
#* *    *      *            #
# *    *   #######      *   #
# *#  #    #######    ####  #
#  #  #          *      *   #
#  #  #    *       *        #
#  #  #    ##   ## *  ####  #
# *        # *   #        * #
#       *  #     #    *     #
#  ####    ##   ##    #  #  #
#          *          #  #  #
#  *               *  #  #  #
#  ####    #######    #* #  #
# *    *   ####### *        #
#   *      *             *  #
#############################