#########################
# *                     #
#  #### * #####   ####  #
#  #  #   #   #   #  #  #
#  #  #   #   #   #  #  #
#  ####   #####   ####  #
#*                      #
#  ####   #####   ####  #
#  #  #   #   #   #  #  #
#  #  #   #   #   #  #  #
#  ####   #####   ####  #
# *                     #
#########################