############################################
# **        ######        ######        ** #
# **        #    #        #    #        ** #
#           #    ####  ####    #           #
#  ######   #                 #   ######   #
#  #    #   ####   ######   ####   #    #  #
#  #    #      #   #    #   #      #    #  #
#  #    ####   #   #    #   #   ####    #  #
#  #          ###  ######  ###          #  #
#  ######   ####            ####   ######  #
#       #   #     ######     #   #         #
#       #   #     #    #     #   #         #
#  ######   ####  #    #  ####   ######    #
#           #     ######     #            *#
# **        #                #        **  *#
# **        ######    ######        **    #
############################################
